NO ./assets/wall.xpm
SO ./assets/wall2.xpm
WE ./assets/wall3.xpm
EA ./assets/wall4.xpm

F 220,100,0
C 225,30,0

1111111111   1111111111111
10000000011111000000000001
11111000000000000000011111
    100000011110000001
    10000001  10000001
    100000011110000001
11111000000000000000011111
1000000000000000000N000001
10000000111111100000000001
111111111     111111111111
111111111     111111111111
