NO ./assets/wall.xpm
SO ./assets/wall2.xpm
WE ./assets/wall3.xpm
EA ./assets/wall4.xpm



F 220,100,0
C 225,30,0


111111
10D0D01
1S1111
110111
111111
