NO ./assets/wall.xpm
SO ./assets/wall2.xpm
WE ./assets/wall3.xpm
EA ./assets/wall4.xpm


F 18,52,86
C 122,89,128



        1111111111111111111111111
        1000000000110000000000001
        1011000001110000000000001
        1001000000000000000000001
1111111110110000011D10000000000001
100000000011000001110111111111111
11110111111111011100000000001
11110111111111011101010000001
11000000110101011100000000001
10000000000000001100000000001
100000000000000011010100S0001
110000011101010111D11011D11000111
11110111 1110101 101111010001
11111111 1111111 111111111111